SO  ./xpm/türk-bay-_1_.xpm
NO	./xpm/azerba-_1_.xpm
WE  ./xpm/bbbb-_1_.xpm
EA	./xpm/kazakistan-_1_.xpm

C	130,145,143
F	244,224,225


1111111111111111111111111
1E00000000000000000000001
1000000000000000000000001
1101000000000000000000001
1000000000000000000000001
1000000000000000000000001
1010101000000000000000001
1101010000000000000000001
1101010000000000000000001
1111111111111111111111111
