SO  ./xpm/türk-bay-_1_.xpm
NO	./xpm/azerba-_1_.xpm
WE  ./xpm/bbbb-_1_.xpm
EA	./xpm/kazakistan-_1_.xpm


C	130,145,143
F	244,224,225

11111111111111111111111111111111111111111111111111
10000000000000000000000000000000000000000000000001
1N111111111111111111111111111111111111111111111111
111
